9 12
0 0
0 8
.......#....
.......#....
.#.....#....
.#.....#....
.#.....#....
.#.....#....
.#.....#....
.#####.####.
............