25 25 4
3 3
21 17
#########################
#.......#.........#.....#
#.#####.#.#.#######.#.###
#.#...#...#.....#...#...#
#.#.#.#.###.#####.#.###.#
#.#.#...#.....#.#.#.....#
#.#.#####.###.#.#.#######
#.#.......#.#.#.#.......#
#.#########.#.#.#######.#
#.#.........#.#.....#...#
#.#.#########.#.###.#.#.#
#.#.#.........#.#.#.#.#.#
#.#.#####.#####.#.#.#.#.#
#.#.....#.....#.#.#.#.#.#
#.#####.#.###.#.#.#.#.#.#
#.......#...#.#.#.#.#.#.#
#.#.#######.#.#.#.#.#.#.#
#.#.#.......#...#.#.#.#.#
#.#.#.###########.#.#.#.#
#.#.#.#...........#.#.#.#
#.#.#.#.###########.#.#.#
#.#.#.#.............#.#.#
#.#.#.###############.#.#
#.#.#.................#.#
#########################

# # # # # # # # # # # # # # # # # # # # # # # # #
# . . . . . . . # . . . . . . . . . # . . . . . #
# . # # # # # . # . # . # # # # # # # . # . # # #
# . # R . . # . . . # . . . . . # . . . # . . . #
# . # . # . # . # # # . # # # # # . # . # # # . #
# . # . # . . . # . . . . . # . # . # . . . . . #
# . # . # # # # # . # # # . # . # . # # # # # # #
# . # . . . . . . . # . # . # . # . . . . . . . #
# . # # # # # # # # # . # . # . # # # # # # # . #
# . # . . . . . . . . . # . # . . . . . # . . . #
# . # . # # # # # # # # # . # . # # # . # . # . #
# . # . # . . . . . . . . . # . # . # . # . # . #
# . # . # # # # # . # # # # # . # . # . # . # . #
# . # . . . . . # . . . . . # . # . # . # . # . #
# . # # # # # . # . # # # . # . # . # . # . # . #
# . . . . . . . # . . . # . # . # . # . # . # . #
# . # . # # # # # # # . # . # . # . # . # . # . #
# . # . # . . . . . . . # . . . # . # . # . # . #
# . # . # . # # # # # # # # # # # . # . # . # . #
# . # . # . # . . . . . . . . . . . # . # . # . #
# . # . # . # . # # # # # # # # # # # . # . # . #
# . # . # . # . . . . . . . . . . F . . # . # . #
# . # . # . # # # # # # # # # # # # # # # . # . #
# . # . # . . . . . . . . . . . . . . . . . # . #
# # # # # # # # # # # # # # # # # # # # # # # # #
