25 25 20
0 0
24 24
..#######################
#.....#........#.......##
#.###.#.######.#.###....#
#.#...#...#....#.#.##..##
#.#.#####.#.###.....#...#
#.#.....#.#...#.#.#.#.#.#
#.#####.#.###.#.#.#.#.#.#
#.....#.#...#.#.#.#.#.#.#
###.#.#.###.#.#.#.#.#.#.#
#...#.#.....#.#...#.#.#.#
#.#######.#.#.###.#.#.#.#
#.........#.#.#...#.#.#.#
#.###########.#.###.#.#.#
#.............#.#...#.#.#
#.###########.#.#.#.#.#.#
#.#...........#.#.#.#.#.#
#.#####.#######.#.#.#.#.#
#...#...#.......#.#.#.#.#
#.#.#.###.#####.#.#.#.#.#
#.#.#.....#.....#.#.#.#.#
#.#.#######.#######.#.#.#
#.#.........#.......#.#.#
#.###########.#####.#.#.#
#.............#.....#.#.#
#####################.#..
