12 35 9
11 18
0 2
.....##..##............#.#.#.#.....
.#..........#.###.#.....#......#.#.
..............#............#....#..
.#..#.......#.##..#...#.#.....#....
...#..#.#.#....#.........##...#....
........#.......#...#.#........##..
...#...#....##.......#..#.#........
#...##.........##...#.#...#........
.......#.....#.........#...........
.#.#....##..................#......
..##....#..........#....#.....#....
.#..........#...#..................
