25 25 12
2 3
20 17
#########################
#.......#.........#.....#
#.#####.#.#.#######.#.###
#.#...#...#.....#...#...#
#.#.#.#.###.#####.#.###.#
#.#.#...#.....#.#.#.....#
#.#.#####.###.#.#.#######
#.#.......#.#.#.#.......#
#.#########.#.#.#######.#
#.#.........#.#.....#...#
#.#.#########.#.###.#.#.#
#.#.#.........#.#.#.#.#.#
#.#.#####.#####.#.#.#.#.#
#.#.....#.....#.#.#.#.#.#
#.#####.#.###.#.#.#.#.#.#
#.......#...#.#.#.#.#.#.#
#.#.#######.#.#.#.#.#.#.#
#.#.#.......#...#.#.#.#.#
#.#.#.###########.#.#.#.#
#.#.#.#...........#.#.#.#
#.#.#.#.###########.#.#.#
#.#.#.#.............#.#.#
#.#.#.###############.#.#
#.#.#.................#.#
#########################
