12 12 5
0 0
11 11
..##########
#......#...#
#.#.####.#.#
#.#......#.#
#.#.######.#
#.#....#.#.#
#.#.#....#.#
#.#.#.##.#.#
#.#......#.#
#.##.#.#####
#....#.....#
##########.#

. . # # # # # # # # # #
# . . . . . . # . . . #
# . # . # # # # . # . #
# . # . . . . . . # . #
# . # . # # # # # # . #
# . # . . . . # . # . #
# . # . # . . . . # . #
# . # . # . # # . # . #
# . # . . . . . . # . #
# . # # . # . # # # # #
# . . . . # . . . . . #
# # # # # # # # # # . #